11. Contattaci
Elenco ﬁ liali ed ufﬁ ci dei Private Banker 
FILIALI DI FIDEURAM 
Abbiategrasso - Alba - Alessandria - Ancona - Arezzo - Asti - Bari - Belluno - Bergamo - Biella - Bologna - Bolzano - Brescia 
- Busto Arsizio - Cagliari - Caserta - Catania - Cernusco Sul Naviglio - Cesena - Como - Cremona - Cuneo - Darfo - Empoli - 
Ferrara - Firenze - Foggia - Forlì - Frosinone - Genova - Ivrea - La Spezia - Latina - Lecce - Lecco - Livorno - Lodi - Lucca - Macerata 
- Mantova - Massa - Messina - Mestre - Milano - Modena - Moncalieri - Montecatini Terme - Monza - Napoli - Novara - Padova 
- Palermo - Parma - Pavia - Perugia - Pescara - Piacenza - Pisa - Pordenone - Prato - Ravenna - Reggio Calabria - Reggio Emilia 
- Rho - Rimini - Roma - Rovigo - Salerno - Sanremo - Savona - Seregno - Sesto San Giovanni - Siena - Siracusa - Torino - Trento 
- Treviglio - Treviso - Trieste - Udine - Varese - Verbania - Verona - Vicenza
UFFICI DEI PRIVATE BANKER DI FIDEURAM 
Acqui Terme - Adrano - Albenga - Aosta - Argenta - Aulla - Avellino - Aversa - Bassano Del Grappa - Bibbiena - Bra - Brunico - 
Campobasso - Carate Brianza - Carpi - Casale Monferrato - Casalgrande - Cascine Di Buti - Castel San Giovanni - Castelfranco 
Veneto - Castelnuovo Garfagnana - Cattolica - Cavalese - Cecina - Chiavari - Chieri - Città di Castello - Cittadella - Conegliano 
- Crema - Domodossola - Fabriano - Faenza - Feltre - Fermo - Foligno - Follonica - Fossano - Gaeta - Gallarate - Gatteo - Gavardo 
- Gorizia - Grosseto - Guastalla - Imola - Imperia - Isernia - Jesi - Lamezia Terme - Lanciano - L’Aquila - Lido di Camaiore - Lugo 
- Monselice - Montebelluna - Montevarchi - Novi Ligure - Oderzo - Omegna - Orbassano - Oristano - Ovada - Pesaro - Pinerolo 
- Piove Di Sacco - Pistoia - Poggibonsi - Pontedera - Portoferraio - Potenza - Rieti - Rivarolo Canavese - Rivoli - Roma - Rovereto 
- Saluzzo - San Benedetto del Tronto - San Daniele Del Friuli - San Giovanni In Persiceto - Santa Croce Sull’Arno - Saronno 
- Sarzana - Sassari - Sassuolo - Schio - Sinalunga - Sondrio - Taranto - Teramo - Terni - Thiene - Tolmezzo - Torino - Trapani - 
Valdagno - Valenza - Velletri - Venezia - Vercelli - Vigevano - Viterbo - Voghera 
UFFICI DEI PRIVATE BANKER DI SANPAOLO INVEST
Abbiategrasso - Acquapendente - Agrigento - Alba Adriatica - Albenga - Alessandria - Ancona - Anzio - Aosta - Arezzo - Asti 
- Aversa - Avezzano - Bari - Barletta - Bergamo - Biella - Bologna - Bolzano - Brescia - Busalla - Caserta - Cassino - Catania - 
Cerea - Chiavari - Città di Castello - Civitanova Marche - Civitavecchia - Como - Cosenza - Cremona - Faenza - Ferrara - Fidenza 
- Firenze - Foggia - Foligno - Forlì - Formia - Frattamaggiore - Frosinone - Gallarate - Genova - Gorizia - Grottaferrata - Imperia 
- Ivrea - L’Aquila - La Spezia - Latina - Lecce - Livorno - Lodi - Lucca - Luino - Matera - Messina - Milano - Modena - Monfalcone 
- Montebelluna - Montepulciano - Monza - Napoli - Nervi - Novara - Ortona - Padova - Palermo - Parma - Perugia - Pesaro - 
Pescara - Piacenza - Pinerolo - Pisa - Prato - Ragusa - Rapallo - Ravenna - Reggio Calabria - Rieti - Rimini - Rivoli - Roma - Salerno 
- Sanremo - Sant’Agnello - Savona - Siena - Susa - Taranto - Terni - Thiene - Torino - Trento - Treviglio - Treviso - Udine - Valenza 
- Vasto - Ventimiglia - Verbania - Vercelli - Verona - Vicenza - Vignola - Viterbo - Voghera
FILIALI DI INTESA SANPAOLO PRIVATE BANKING 
Alba - Alessandria - Ancona - Aosta - Arezzo - Asti - Avellino - Bari - Bassano del Grappa - Belluno - Bergamo - Biella - Bologna 
- Bolzano - Borgomanero - Brescia - Busto Arsizio - Cagliari - Cantù - Casale Monferrato - Casalecchio di Reno - Caserta - Catania - 
Catanzaro - Cerea - Chieri - Chioggia - Cittadella - Como - Conegliano - Cosenza - Crema - Cremona - Cuneo - Dolo - Empoli - Ferrara 
- Firenze - Foggia - Forlì - Frosinone - Genova - Grosseto - Imola - Ivrea - La Spezia - Lecce - Lecco - Legnano - Lodi - Lucca - Mantova 
- Melzo - Messina - Mestre - Milano - Modena - Moncalieri - Monza - Napoli - Novara - Novi Ligure - Padova - Palermo - Parma - Pavia 
- Perugia - Pesaro - Pescara - Pinerolo - Piove di Sacco - Pistoia - Pordenone - Prato - Ravenna - Reggio Calabria - Reggio Emilia - Rimini - 
Rivoli - Roma - Rovigo - San Benedetto del Tronto - Salerno - San Donà di Piave - San Giuseppe Vesuviano - Sanremo - Sassari - Savona 
- Schio - Taranto - Terni - Torino - Trento - Treviso - Trieste - Udine - Varese - Venezia - Verbania - Vercelli - Verona - Vicenza - Vigevano
UFFICI DEI PRIVATE BANKER DI INTESA SANPAOLO PRIVATE BANKING
Bari - Salò 
FILIALI DEL GRUPPO INTESA SANPAOLO PRIVATE BANK (SUISSE) MORVAL
George Town - Ginevra - Londra - Lugano 
(aggiornato al 31 dicembre 2019)
434 Annual Report Integrato 2019   Fideuram - Intesa Sanpaolo Private Banking   